+ + + + + + + + + + +
+ $ X - @ - - - - - +
+ - - - - - - - - - +
+ - @ @ - - - - - - +
+ $ - - - - - - - + +
+ % $ X - + + + + + +
+ + + + + + + + + + +
