+ + + + + +
+ * @ X + +
+ @ @ + + +
+ - X - - +
+ - - - - +
+ X X @ - +
+ + + + + +
