+ + + + + + + +
+ - - X - - - +
+ % @ - - X - +
+ - @ @ $ - - +
+ - - - - - - +
+ + + + + + + +
