+ + + + + + + + + + +
+ - - * - - - - - - +
+ - @ - - X @ - - X +
+ - - @ $ - X @ - + +
+ - X - - - - - - + +
+ + + + + + + + + + +
