+ + + + + + +
+ + - - + + +
+ + - - - + +
+ - - - - + +
+ - - - - - +
+ $ @ X + - +
+ - - - - + +
+ $ - @ - + +
+ * @ X X + +
+ + + + + + +
