+ + + + + + +
+ * - @ - X +
+ + - @ - + +
+ X - - - - +
+ + + + + + +