+ + + + + + + + + + + + + +
+ - - - - - - - - - - - - +
+ - - - $ + - - @ - - - X +
+ - - - - - - - * @ + - X +
+ - - - - - - - - - - - - +
+ - $ - - - - - - - - - - +
+ - - - - - - - - - - - - +
+ + + + + + + + + + + + + +