- + + + + + + + + + +
- + X + - - - @ X X +
+ + - - @ * @ + + + +
+ - - - - - - - + - -
+ X @ - + + + + + - -
+ + + + + - - - - - -