+ + + + + + + + + + +
+ - $ + - @ - - - X +
+ - - - - * @ + - X +
+ - - - - - - - - - +
+ X @ - - - - - - - +
+ + + + + + + + + + +