- - + + + + + +
- + + - - - * +
+ + - - - + X +
+ X - @ - @ @ +
+ X X @ - - - +
+ + + + + + + +