+ + + + + + + + + + +
+ - $ + - @ - - - X +
+ - - - - * @ + - X +
+ - - - - - - - - - +
+ $ - - - - - - - - +
+ + + + + + + + + + +