+ + + + + + - - - + + + + + +
+ % - - - + - - - + - - - X +
+ - - - @ + - - - + @ - - - +
+ - - - - + + + + + - - - - +
+ - - - - - - - $ - - - - - +
+ - - - - - - - $ - - - - - +
+ - - - - + + + + + - - - - +
+ - - - @ + - - - + @ - - - +
+ X - - - + - - - + - - - X +
+ + + + + + - - - + + + + + +