- + + + + + + - - -
- + - - - X + - - -
+ + - @ - + + - - -
+ - - - - + + - - -
+ - @ - - * + + + +
+ + - - - - - - X +
- + + + + + + + + +