+ + + + + + + + + + + + + 
+ - X - @ - - - - - - - +
+ - - - - - - - - + - - +
+ - @ - - X - + - @ X - +
+ - - - - - - @ - - + - +
+ - - * - X - - - - - - +
+ + + + + + + + + + + + +