- + + + + + + + - -
+ + - - + - - + + +
+ - @ - + - @ - - +
+ - - X * X - - - +
+ + @ - + - @ + + +
- + - X - X - + - -
- + + + + + + + - -