- + + + + + + + - -
+ + - - + - - + + +
+ - @ - - - @ - - +
+ - - X * X - - - +
+ + @ + + - - + + +
+ - - X - - - + - -
+ + + + + + + + - -