- - - + + + + + + + +
- - - + - - - - - - +
- - + + - - - - @ - +
- + + - - + + - + + +
+ + - - + - - X - - +
+ - - + X @ @ - - + +
+ * + X - - - - + + -
+ + - - - - - + + - -
+ + + + + + + + - - -