+ + + + + + + +
+ * - @ - X - +
+ + - - - + X +
+ X - @ - @ - + 
+ X - @ - - - +
+ + + + + + + +