+ + + + + + + +
+ - - @ - X * +
+ + - - - + X +
+ X - @ - @ - + 
+ X - @ - - - +
+ + + + + + + +